1 1 1 1 1 1 1 1 1 1 1 1 1 1 1 1 1 1 1 7 7 7 7 7 7 7 7 7 7 7 7 7 7 7 7 7 7 7 7 7 7 7 7 7 7 7 7 7 7 7 7 7 7 4 4 4 4 4 9 9 9 9 9 9 9 9 9 9 4 2 2 2 2 2 2 2 2 2 2 4 
1 7 7 7 0 0 0 0 0 0 0 0 0 0 0 0 7 0 1 7 7 7 7 7 7 7 7 7 7 0 0 0 6 6 6 6 6 6 6 6 6 6 6 6 6 6 6 6 6 6 6 0 0 0 0 0 0 0 4 4 9 9 9 9 4 4 4 4 0 0 0 2 2 2 5 5 5 5 5 4 
1 7 7 0 0 0 0 0 0 0 0 0 0 0 0 0 0 0 1 0 0 0 0 7 7 7 7 0 0 7 0 0 6 6 6 6 6 6 6 6 6 6 6 6 6 6 6 6 6 6 0 0 0 0 0 0 0 0 0 0 4 4 4 4 0 0 0 0 0 0 0 0 0 2 2 5 5 8 0 4 
1 7 0 0 0 0 0 0 0 0 0 0 0 0 0 0 3 3 3 6 6 6 6 6 6 6 6 6 6 6 6 6 6 6 0 7 0 0 0 0 7 7 7 0 0 0 0 0 0 0 0 0 0 0 0 0 0 0 0 0 0 0 0 0 0 0 0 0 0 0 0 0 0 2 2 5 5 0 0 4
1 0 0 0 0 0 0 0 0 0 0 0 0 0 0 0 3 3 3 6 6 6 6 6 6 6 6 6 6 6 6 6 6 6 7 7 7 7 7 7 7 7 7 7 7 7 7 0 0 0 0 0 0 0 0 0 0 0 0 0 0 0 0 0 0 0 0 0 0 0 0 0 0 2 2 2 5 5 8 4                                                                         
1 0 0 0 0 0 0 0 0 0 0 0 0 0 0 0 0 0 1 0 0 0 0 7 0 0 0 0 0 0 0 0 6 6 0 7 7 0 0 0 7 7 7 7 7 7 7 7 0 0 0 0 0 0 0 0 0 0 0 0 0 0 0 0 0 0 0 0 0 0 0 0 0 0 2 2 2 5 0 4 
1 0 0 0 0 0 0 0 0 0 0 0 0 0 0 0 0 0 1 0 0 7 0 0 0 7 0 0 0 7 0 0 6 6 0 0 0 0 4 4 0 7 7 7 7 0 4 4 0 0 0 0 0 0 0 0 0 0 0 0 0 0 0 0 0 0 0 0 0 0 0 0 0 0 0 2 2 5 0 4 
1 0 0 0 0 0 0 0 0 0 0 0 0 0 0 0 0 0 1 0 0 4 4 4 4 4 4 0 0 0 0 0 6 6 0 0 0 4 4 4 4 0 0 7 0 4 4 4 4 0 0 0 0 0 0 0 0 0 0 0 0 0 0 0 0 0 0 0 0 0 0 0 0 0 8 2 2 0 0 4 
1 0 0 0 0 0 0 0 0 0 0 0 0 0 0 0 0 0 1 0 4 4 4 4 9 9 4 4 4 4 4 4 6 6 0 0 4 4 9 9 4 4 4 4 4 4 9 9 4 4 0 0 0 0 0 0 0 0 0 0 0 0 0 0 0 0 0 0 0 0 0 0 0 0 0 2 2 0 0 4 
1 0 0 0 0 0 0 0 0 0 0 0 0 0 0 0 0 1 1 4 4 9 9 9 9 9 9 9 9 9 4 4 6 6 0 4 4 9 9 9 4 4 4 4 4 9 9 9 4 4 4 0 0 0 0 0 0 0 0 0 0 0 0 0 0 0 0 0 0 0 0 0 0 8 2 2 0 0 0 4 
1 0 0 0 0 0 0 0 0 0 0 0 0 0 0 0 0 1 4 4 9 9 9 9 9 9 9 9 9 9 4 4 6 6 0 4 4 9 9 9 9 9 9 9 9 9 9 9 9 4 4 4 0 0 0 0 0 0 0 0 0 0 0 0 0 0 0 0 0 0 0 0 8 2 2 2 0 0 0 4 
1 0 0 0 0 0 0 0 0 0 0 0 0 0 0 0 0 1 4 4 9 9 9 9 9 9 9 9 9 4 4 0 6 6 4 4 4 9 9 9 9 9 9 9 9 9 9 9 9 9 4 4 4 0 0 0 0 0 0 0 0 0 0 0 0 0 0 0 0 0 0 8 2 2 2 0 0 0 0 4 
1 0 0 0 3 3 0 0 0 0 0 0 0 0 0 0 0 1 4 4 4 9 9 9 9 9 9 9 9 4 4 0 6 6 4 4 9 9 9 9 9 9 9 9 9 9 9 9 9 9 9 4 4 4 0 0 0 0 0 0 0 0 0 0 0 0 2 2 2 2 2 2 2 2 0 0 0 0 4 9 
1 0 0 0 3 3 0 0 0 0 0 0 0 0 0 0 0 1 0 4 4 9 9 9 9 9 9 9 4 4 4 0 6 6 4 4 9 9 9 9 9 9 9 9 9 9 9 9 9 9 9 9 4 4 0 0 0 0 0 0 0 7 7 2 2 2 2 2 2 2 2 2 2 0 8 0 0 4 9 9 
1 0 0 0 3 3 0 0 0 0 0 0 0 0 7 0 1 1 0 4 4 9 9 9 9 9 9 9 4 4 0 6 6 6 4 4 9 9 9 9 9 9 9 9 9 9 9 9 9 9 9 9 9 4 4 0 0 7 0 7 7 2 2 2 2 2 2 0 0 0 0 0 0 0 0 0 0 4 9 9 
1 0 7 0 6 6 0 0 7 7 0 1 1 1 1 1 1 0 0 4 4 9 9 9 9 9 9 9 4 4 6 6 6 4 4 4 9 9 9 9 9 9 9 9 9 9 9 9 9 9 9 9 9 4 4 4 0 0 7 0 2 2 2 2 0 0 0 0 0 0 0 0 0 0 0 0 0 4 4 9 
1 1 1 1 6 6 1 1 1 1 1 1 0 0 0 0 0 0 0 4 4 4 9 9 9 9 9 9 4 4 6 6 0 4 4 9 9 9 9 9 9 9 9 9 9 9 9 9 9 9 9 9 9 4 4 4 4 0 2 2 2 0 8 0 0 0 0 0 0 0 0 0 0 0 0 0 0 0 4 4 
2 5 5 0 6 6 0 0 0 0 0 0 0 0 0 0 0 0 0 0 4 4 9 9 9 9 9 9 4 4 6 6 0 9 9 9 9 9 9 9 9 9 9 9 9 9 9 9 9 9 9 9 9 4 4 4 4 4 2 2 8 0 0 0 0 0 0 0 0 0 0 0 0 0 0 0 0 0 0 4 
2 2 5 5 6 6 0 0 0 0 0 0 0 0 0 0 0 0 0 0 4 4 4 9 9 9 9 9 4 4 6 6 0 4 4 9 9 9 9 9 9 9 9 9 9 9 9 9 9 9 9 9 9 9 4 0 0 0 2 2 7 0 0 0 0 0 0 0 0 0 0 0 0 0 0 0 0 0 0 4 
2 2 5 5 6 6 6 0 0 0 0 0 0 0 0 0 0 0 0 0 0 0 4 4 9 9 9 9 4 4 6 6 0 4 4 4 9 9 9 9 9 9 9 9 9 9 9 9 9 9 9 9 9 4 4 0 0 2 2 0 7 0 0 0 0 0 0 0 0 0 0 0 0 0 0 0 0 0 0 4 
2 2 2 5 5 6 6 6 0 0 0 0 0 0 0 0 0 0 0 0 0 0 4 4 4 4 9 4 4 4 6 6 0 0 4 4 9 9 9 9 9 9 9 9 9 9 9 9 9 9 9 9 4 4 0 0 2 2 0 7 0 0 0 0 0 0 0 0 0 0 0 0 0 0 0 0 0 0 0 4 
2 2 2 5 5 0 6 6 0 0 0 0 0 0 0 0 0 0 0 0 0 0 0 4 4 4 9 4 4 6 6 6 0 0 0 4 4 9 9 9 9 9 9 9 9 9 9 9 9 9 9 4 4 0 0 2 2 2 8 0 0 0 0 0 0 0 0 0 0 0 0 0 0 0 0 0 0 0 0 4 
2 2 2 5 5 8 6 6 0 0 0 0 0 0 0 0 0 0 0 0 0 0 0 7 4 4 9 4 0 6 6 0 0 0 0 7 4 4 9 9 9 9 9 9 9 9 9 4 4 4 4 4 0 0 0 2 2 0 0 0 0 0 0 0 0 0 0 0 0 0 0 0 0 0 0 0 0 0 0 4 
2 2 2 5 5 0 6 6 0 0 0 0 0 0 0 0 0 0 0 0 0 0 0 0 7 4 4 4 0 6 6 0 0 7 0 0 0 4 4 4 4 4 4 4 4 9 4 4 4 4 4 0 0 0 0 2 2 0 0 0 0 0 0 0 0 0 0 0 0 0 0 0 0 0 0 0 0 0 0 4 
2 2 2 2 5 5 6 6 0 0 0 0 0 0 0 0 0 0 0 0 0 0 0 0 0 4 4 4 0 6 6 7 0 0 0 7 0 7 7 0 0 0 0 4 4 4 4 4 0 0 0 0 0 0 0 0 2 0 0 0 0 0 0 0 0 0 0 0 0 0 0 0 0 0 0 0 0 0 0 4 
2 2 2 2 2 5 6 6 0 0 0 0 0 0 0 0 0 0 0 0 0 0 0 0 0 0 0 0 0 0 0 0 0 0 0 0 0 0 0 0 0 6 6 6 6 6 6 6 6 6 6 6 6 3 3 3 3 3 3 3 0 0 0 0 0 0 0 0 0 0 0 0 0 0 0 0 0 4 4 9 
2 2 2 2 2 5 3 3 3 3 3 3 3 3 3 3 3 3 3 3 0 0 0 0 0 0 0 0 0 0 0 0 0 0 0 6 6 6 6 6 6 6 6 6 6 6 6 6 6 6 6 6 6 3 3 3 3 3 3 3 0 0 0 0 0 0 0 0 0 0 0 0 0 0 0 4 4 4 9 9 
2 2 2 2 2 5 3 3 3 3 3 3 3 3 3 3 3 3 3 3 3 3 3 3 3 3 3 0 0 0 0 0 6 6 6 6 6 6 6 6 6 4 4 4 4 4 4 4 4 4 4 4 0 0 0 0 2 0 0 0 0 0 0 4 4 4 4 0 0 0 0 0 0 0 4 4 9 9 9 9 
2 2 2 2 2 2 5 5 5 5 5 5 5 5 5 5 5 5 5 5 3 3 3 3 3 3 3 0 0 0 0 0 6 6 6 6 7 7 4 4 4 9 9 9 9 9 9 9 9 9 9 9 4 4 4 4 2 2 2 0 0 4 4 4 9 9 9 4 0 0 0 4 4 4 4 9 9 9 9 9 
2 2 2 2 2 2 2 2 2 2 2 2 2 2 2 2 2 2 2 2 5 4 4 4 4 4 4 4 4 4 4 4 7 7 7 7 7 4 9 9 9 9 9 9 9 9 9 9 9 9 9 9 9 9 9 9 4 2 2 2 4 9 9 9 9 9 9 9 4 4 4 9 9 9 9 9 9 9 9 9 
1 2 3 4 5 6 7 8 9 0 1 2 3 4 5 6 7 8 9 0 1 2 3 4 5 6 7 8 9 0 1 2 3 4 5 6 7 8 9 0 1 2 3 4 5 6 7 8 9 0 1 2 3 4 5 6 7 8 9 0 1 2 3 4 5 6 7 8 9 0 1 2 3 4 5 6 7 8 9 0